1111111111111111111111
100001000C000000000001
10PCC0000C0C0100000001
1011100000000100000001
1000000001000000000001
10000000000E00000C0001
1000000000000000000001
1111111111111111111111