111111111111111111111111111111
100000000000000P00000000000001
1010C0000000000000000000000001
100000000000000000000000000001
110000000000000000000000000001
100000000000000001000000000001
10000000C000000000000000000001
100000000000000000000000000001
10000000000000000000000000C001
100000000000000000000000000001
100000C00000C00000000000000001
10000000000000000000C000000001
100000000000000000000000000001
100000000000000000000000000001
1000000000000000C0000000000001
100000010000000000000000000001
100000000000000000000000000001
100000000010001000000000000001
100000000000000000000000000001
100000000000000000000000100001
100000000000000000000000000001
100000000000000000000000000001
10000000E000000000000000000001
1C00000000000000010000000C0001
100000001000000000000000000001
100000000000000000000000000001
100000000000010000000000000001
100000000000000000000000000001
1000000000C0000000000000000001
111111111111111111111111111111