11111111111111111111
10000000000000E00001
10001000000100000001
1000100000000!000001
100010000!0000000001
10001000000000000001
10001000C00000000001
10000C000000000C0001
10001000000000000001
10001000000100000001
100010C00!0000000001
100010100000000C1001
1000000P00000C000001
10000000000000000001
11111111111111111111