11111111111111111111111111111111
10000000000000E00001000000000001
10001000000100000001000000000001
10001000000000000001000000000001
10001000000000000001000000000001
1000100000000000000000000C000001
10001000C00000000000000000000001
10000C000000000C0001000000000001
10001000000000000001000000000001
10001000000100000001000000000001
100010C0000000000001000000000001
100010100000000C1001000000000001
1000000P00000C000001000000000001
10000000000000000001C000000000C1
11111111111111111111111111111111