1111111111111111111
1fsafoidhaskjfhakj1
1111111111111111111