111111111111111111111
10000000P00000E000011
100010000001000000011
100010000000000000011
100010000000000000011
10001000000000P000011
10001000C000000000011
100010000000000000011
100010000001000E00011
100010C00000000000011
100010100000000C10011
100000000P000C0000011
100000000000000000011
111111111111111111111