111111111111
1PP0C1000!01
1EC1000C0001
111111111111